1111111111111111111111
10000000C000C000000001
1001110000E00000111001
1P000000C000C000000001
1111111111111111111111
