1111111111111111111111111111111111
100E00000000000000000000000000E001
10000000000000CCCCC000000000000001
10000000000000C1P1C000000000000001
10000000000000CCCCC000000000000001
100E00000000000000000000000000E001
1111111111111111111111111111111111
