111111111111111111111111111111111111111111111111111
111111111111111111111111111111100000000000111111101
1111111111111111111111111111111000000000001111111C1
1111111111111111111111111111111000E0000000111111101
1111111111111111111111111111111000C0000000111111101
1111111111111111111111111111111000P0000000111111101
111111111111111111111111111111100000000000111111101
111111111111111111111111111111111111111111111111101
111111111111111111111111111111111111111111111111101
111111111111111111111111111111111111111111111111101
111111111111111111111111111111111111111111111111111
111111111111111111111111111111111111111111111111111
111111111111111111111111111111111111111111111111111
111111111111111111111111111111111111111111111111111
111111111111111111111111111111111111111111111111111
111111111111111111111111111111111111111111111111111
111111111111111111111111111111111111111111111111111
111111111111111111111111111111111111111111111111111
111111111111111111111111111111111111111111111111111
1111111111111111111111111111111111111111111111111E1
111111111111111111111111111111111111111111111111111
111111111111111111111111111111111111111111111111111
111111111111111111111111111111111111111111111111111
111111111111111111111111111111111111111111111111111
111111111111111111111111111111111111111111111111111
111111111111111111111111111111111111111111111111111
1111111111111111111111111111111111111111111111111C1
111111111111111111111111111111111111111111111111111
