11111111
1000P0C1
00E0E0C1
100000C1
11111111
