11111111
1P0000C1
100EE0C1
100000C1
11111111
