11111111
10P0P0C1
10E0E0C1
100000C1
11111111
