NO srcs/textures/wall1.XPM
SO srcs/textures/wall2.XPM
WE srcs/textures/wall3.XPM
EA srcs/textures/wall4.XPM
F 25          ,              184        ,                        11
C 117,225,253
 11111111111111111111111111111111111111111111111111111111111111111111111111111111111111111111111
1000000000000000W00000000000000000000000000000000000000000000000000000000000000000000001
1000000000000000000000000000000000000000000000000000000000000000000000000000000000000001
100000000000000000000000000000000000000000000000000000000000000000000000000000000000000111
100000000000000000000010010000000000000000000000000000000000000000000000000000000000000001
100000000000000000000100010000000000000000000000000000000000000000000000000000000000000001
100000000000000000001000001000000000000000000000000000000000000000000000000000000000000001
1000000000000000000100000010000000000000000000000000000000000000000000000000000000000000011111111111111111111111
 1000000000000000001000000001000000000000000000011111111111111111111111111111110000000000000000000000000000000001
10000000000000000100000100000100000000000000000000000000000000000000000000001000000000000011111111111111111111111111
 10000000000000001000001000000100000000000000000011111111111111111111110000000110000000000000110000000000000000000001
100000000000000100000100000000110000000000000000000000000000000000000011000001000000000000000011111111111111111111111
 1000000000000010000010000000000010000000000000000000000000000000000000100000010000000000000011
100000000000010000000000000000001000000000000000000000000000000000000010000001000000000000011
1000000000001000000100000000000000100000000000000000000000000000000000100000010000000000000011
1000000000010000001000000000000000010000000000000000000000000000000000100000010000000000000011
1000000000100000010000000010000000000100000000000000000000000000000000100000010000000000000001
1000000001000000000000001000000000000100000000000000000000000000000000100000010000000000000011
100000001000000000000001000000000000000000000000000000000000000000000010000001000000000000011
100000010000000000000010000000000000001000000000000000000000000000000010000001000000000000001
100000100000000000000100000000000000000100000000000000000000000000000000000000000000000000111
10000100000000000000100000000000000000001000000000000000000000000000000000000000000000000011
10001000000000000000000000000000000000000000000000000000000000000000000000000000000000001111
11111111111111111111111111111111111111111111111111111111111111111111111111111111111111111
