NO textures/wall1.XPM
SO textures/wall2.XPM
WE textures/wall3.XPM
EA textures/wall4.XPM
F 101,0,101
C 101,0,101
11111
10001
10E01
10001
11111
